%%%%%%%%%
% P     % 
% % % %%%  
%    .%%% 
%%%%%%%%%
